1111111111111111111111111
1000000000000000000000001
1000000000000000E00000001
10000P0000000000000000001
1000000000000000000000001
1000000000CCCCC0000000001
1000000000000000000000001
1000000000000000000000001
1111111111111111111111111
1000000000000000C00000001
1111111111111111111111111
