11111111111111
10000000000001
10000000P00001
10000000000001
10000000000001
10000000000001
100E0000000001
10000000000001
10000000000001
11111111111111
