1111111111111111111
10000C0000000000001
100000000000C000001
100P000C00000000001
100000000000000C001
1111111111111111111

