1111111111111
1000000000001
10000C0000001
10000000C0001
100E000000001
1000000CC0001
1111111111111
