1111111
10O0O01
1PCW0E1
1111111
