11111111111111111111111111111111
100000000000000000001111111111111111111111111111111111111
1PCE00000000000000000000000000000000001
11111111111111110000000C111111111111111
111111111111111111111111111
