111111111111111111111111111111111111111111111111111111111111
1E0000000000000C00000C000000000000000000000000000000000000C1
101001010010000010100100000001010000000000000000000000000001
101001001010101000100100000001010000000000000010000000000001
1C0000000C00C0000000000000000000C000000000000000000000000001
100000000000000000000000000000000000000000000000000000000001
100000000000000000000000000000000000000000000100000000000001
100000000000000000000000000000000000000000000000000000000001
100011000000000000000000000000000000000000000000000000000001
100000000000000000000000000000000000000100000000000000000001
100000000000000000000000000000000000000000000000000000000001
100000000000000001000000000000000000000000000000000000000001
100000000000000000000000000000000000000000000000000000000001
100000001100000000000000000000000000000000000000000000000001
100000000000000000000000000000000000000000000000000000000001
100000000000010000000000000000P00000000000000000000000000001
100000000000011000000000000000000000000000000000000000000001
100000000000000000000000000000000000000000000000000000000001
100000000000000000000001100000000000000000000000000000000001
100000000000000000000000100000000000000000000000000000000001
100000000000000000000000000000000000000000000000000000000001
100010000000000000000000000000000000000000000010000000000001
100000000000000000000000000000000000000000000000000000000001
100000000000000000000000000000000100000000000000000000000001
100000000001000000000000001000000000000000000000000000000001
100000000000000000000000000000000000000000000000000000000001
100000000000000000000000000000000000000000000000000000000001
10000000000000000C000000000000000000000000000000000000000001
100000000000000000000000000000000000000000000000000000000001
1000000000000000000000000000000000000000000000000000000000C1
111111111111111111111111111111111111111111111111111111111111
