111111111111111111111111111
1P10000000000000000010001C1
101110111111011111100010101
101000111110001111111110101
1C0011000000111000111000001
111111011011111100001111111
100000000000000000100000001
1C11101111101011101111111E1
111111111111111111111111111
