11111111
1E000001
100000C1
100000P1
11111111
